200
7
0
S2 E0 E0 E0 E0 E0 E0 
S2 E0 E0 E0 E0 E0 E0 
S2 E0 E0 E0 E0 E0 E0 
S2 E0 E0 E0 E0 E0 E0 
S2 E0 E0 E0 E0 E0 E0 
S2 E0 E0 E0 E0 E0 E0 
S2 E0 E0 E0 E0 E0 E0 
S2 E0 E0 E0 E0 E0 E0 
S2 E0 E0 E0 E0 E0 E0 
S2 E0 E0 E0 E0 E0 E0 
S2 E0 E0 E0 E0 E0 E0 
S2 E0 E0 E0 E0 E0 E0 
S2 E0 E0 E0 E0 E0 E0 
S2 E0 E0 E0 E0 E0 E0 
S2 E0 E0 E0 E0 E0 E0 
S3 E0 E0 E0 E0 E0 E0 
S3 E0 E0 E0 E0 E0 E0 
S3 E0 E0 E0 E0 E0 E0 
S3 E0 E0 E0 E0 E0 E0 
S3 E0 E0 E0 E0 E0 E0 
S3 E0 E0 E0 E0 E0 E0 
S3 E0 E0 E0 E0 E0 E0 
S3 E0 E0 E0 E0 E0 E0 
S3 E0 E0 E0 E0 E0 E0 
S3 E0 E0 E0 E0 E0 E0 
S4 E0 E0 E0 E0 E0 E0 
S4 E0 E0 E0 E0 E0 E0 
S4 E0 E0 E0 E0 E0 E0 
S4 E0 E0 E0 E0 E0 E0 
S4 E0 E0 E0 E0 E0 E0 
S4 E0 E0 E0 E0 E0 E0 
S4 E0 E0 E0 E0 E0 E0 
S4 E0 E0 E0 E0 E0 E0 
S4 E0 E0 E0 E0 E0 E0 
S4 E0 E0 E0 E0 E0 E0 
S4 E0 E0 E0 E0 E0 E0 
S4 E0 E0 E0 E0 E0 E0 
S4 E0 E0 E0 E0 E0 E0 
S4 E0 E0 E0 E0 E0 E0 
S6 E0 E0 E0 E0 E0 E0 
S6 E0 E0 E0 E0 E0 E0 
S6 E0 E0 E0 E0 E0 E0 
S6 E0 E0 E0 E0 E0 E0 
S6 E0 E0 E0 E0 E0 E0 
S6 E0 E0 E0 E0 E0 E0 
S6 E0 E0 E0 E0 E0 E0 
S6 E0 E0 E0 E0 E0 E0 
S6 E0 E0 E0 E0 E0 E0 
S6 E0 E0 E0 E0 E0 E0 
S2 E0 E0 E0 E0 E0 E0 
S2 E0 E0 E0 E0 E0 E0 
S2 E3 S1 E0 E0 E0 E0 
S2 E3 S1 E0 E0 E0 E0 
S2 E3 S1 E0 E0 E0 E0 
S2 E3 S1 E0 E0 E0 E0 
S2 E3 S1 E0 E0 E0 E0 
S2 E3 S3 E0 E0 E0 E0 
S2 E3 S3 E0 E0 E0 E0 
S2 E3 S3 E0 E0 E0 E0 
S2 E3 S3 E0 E0 E0 E0 
S2 E3 S3 E0 E0 E0 E0 
S2 E3 S5 E0 E0 E0 E0 
S2 E5 S3 E0 E0 E0 E0 
S2 E5 S3 E0 E0 E0 E0 
S2 E5 S3 E0 E0 E0 E0 
S2 L1 E4 S3 E0 E0 E0 
S2 L1 E4 S3 E0 E0 E0 
S4 E3 S3 E0 E0 E0 E0 
S4 E3 S3 E0 E0 E0 E0 
S4 E3 S3 E0 E0 E0 E0 
S4 E3 S3 E0 E0 E0 E0 
S4 E3 S1 L1 E0 E0 E0 
S4 E3 S1 L1 E0 E0 E0 
S4 E3 S1 L1 E0 E0 E0 
S4 E3 S1 L1 E0 E0 E0 
S4 E3 S1 L1 E0 E0 E0 
S4 E3 S3 E0 E0 E0 E0 
S2 L1 E5 S2 E0 E0 E0 
S2 L1 E5 S2 E0 E0 E0 
S2 L1 E5 S2 E0 E0 E0 
S2 E5 S3 E0 E0 E0 E0 
S2 E5 S1 L1 E0 E0 E0 
S2 E5 S1 L1 E0 E0 E0 
S2 E5 S1 L1 E0 E0 E0 
S2 E5 S1 L1 E0 E0 E0 
S2 E5 S1 L1 E0 E0 E0 
S2 E5 S5 E0 E0 E0 E0 
S2 E5 S5 E0 E0 E0 E0 
S2 E5 S5 E0 E0 E0 E0 
S2 E5 S5 E0 E0 E0 E0 
S2 E5 S5 E0 E0 E0 E0 
S2 E7 S1 L1 E0 E0 E0 
S2 E7 S1 L1 E0 E0 E0 
S2 E7 S1 L1 E0 E0 E0 
S2 E7 S1 L1 E0 E0 E0 
S2 E7 S1 L1 E0 E0 E0 
S3 E6 S5 E0 E0 E0 E0 
S3 E6 S5 E0 E0 E0 E0 
S3 E6 S5 E0 E0 E0 E0 
S3 E6 S5 E0 E0 E0 E0 
S3 E6 S5 E0 E0 E0 E0 
S4 E7 S1 L1 E0 E0 E0 
S4 E7 S1 L1 E0 E0 E0 
S4 E7 S1 L1 E0 E0 E0 
S4 E7 S1 L1 E0 E0 E0 
S4 E7 S1 L1 E0 E0 E0 
S5 E6 S5 E0 E0 E0 E0 
S5 E6 S5 E0 E0 E0 E0 
S5 E6 S5 E0 E0 E0 E0 
S5 E6 S5 E0 E0 E0 E0 
S5 E6 S5 E0 E0 E0 E0 
S6 E5 S5 E0 E0 E0 E0 
S6 E7 S3 E0 E0 E0 E0 
S6 E8 S2 E0 E0 E0 E0 
S6 E9 S1 E0 E0 E0 E0 
S6 E9 S1 E0 E0 E0 E0 
S8 E0 E0 E0 E0 E0 E0 
S8 E0 E0 E0 E0 E0 E0 
S8 E0 E0 E0 E0 E0 E0 
S8 E0 E0 E0 E0 E0 E0 
S8 E0 E0 E0 E0 E0 E0 
S10 E0 E0 E0 E0 E0 E0 
S10 E0 E0 E0 E0 E0 E0 
S10 E0 E0 E0 E0 E0 E0 
S10 E0 E0 E0 E0 E0 E0 
S10 E0 E0 E0 E0 E0 E0 
S9 E0 E0 E0 E0 E0 E0 
S9 E0 E0 E0 E0 E0 E0 
S9 E0 E0 E0 E0 E0 E0 
S9 E0 E0 E0 E0 E0 E0 
S9 E0 E0 E0 E0 E0 E0 
S8 E0 E0 E0 E0 E0 E0 
S8 E0 E0 E0 E0 E0 E0 
S8 E0 E0 E0 E0 E0 E0 
S8 E0 E0 E0 E0 E0 E0 
S8 E0 E0 E0 E0 E0 E0 
S7 E0 E0 E0 E0 E0 E0 
S7 E0 E0 E0 E0 E0 E0 
S7 E0 E0 E0 E0 E0 E0 
S7 E0 E0 E0 E0 E0 E0 
S7 E0 E0 E0 E0 E0 E0 
S5 L1 E0 E0 E0 E0 E0 
S5 L1 E0 E0 E0 E0 E0 
S5 L1 E0 E0 E0 E0 E0 
S5 L1 E0 E0 E0 E0 E0 
S5 L1 E0 E0 E0 E0 E0 
S7 E0 E0 E0 E0 E0 E0 
S7 E0 E0 E0 E0 E0 E0 
S7 E0 E0 E0 E0 E0 E0 
S7 E0 E0 E0 E0 E0 E0 
S7 E0 E0 E0 E0 E0 E0 
S5 L1 E0 E0 E0 E0 E0 
S5 L1 E0 E0 E0 E0 E0 
S5 L1 E0 E0 E0 E0 E0 
S5 L1 E0 E0 E0 E0 E0 
S5 L1 E0 E0 E0 E0 E0 
S9 E0 E0 E0 E0 E0 E0 
S9 E0 E0 E0 E0 E0 E0 
S9 E0 E0 E0 E0 E0 E0 
S9 E0 E0 E0 E0 E0 E0 
S9 E0 E0 E0 E0 E0 E0 
S5 L1 E0 E0 E0 E0 E0 
S5 L1 E0 E0 E0 E0 E0 
S5 L1 E0 E0 E0 E0 E0 
S5 L1 E0 E0 E0 E0 E0 
S5 L1 E0 E0 E0 E0 E0 
S5 L1 S1 E2 S2 E0 E0 
S5 L1 S1 E1 L1 S2 E0 
S5 L1 S1 E1 L1 S2 E0 
S5 L1 S1 E1 L1 S2 E0 
S5 L1 S1 E1 L1 S2 E0 
S7 E3 S3 E0 E0 E0 E0 
S7 E3 S3 E0 E0 E0 E0 
S7 E3 S3 E0 E0 E0 E0 
S7 E3 S3 E0 E0 E0 E0 
S7 E3 S3 E0 E0 E0 E0 
S7 E5 S3 E0 E0 E0 E0 
S7 E5 S3 E0 E0 E0 E0 
S7 E5 S3 E0 E0 E0 E0 
S7 E5 S3 E0 E0 E0 E0 
S7 E5 S3 E0 E0 E0 E0 
S7 L1 E3 L1 S3 E0 E0 
S7 L1 E3 L1 S3 E2 S6 
S7 E5 S3 E2 S6 E0 E0 
S7 E5 S3 E2 S2 E0 E0 
S7 E5 S3 E2 S2 E0 E0 
S7 E5 S3 E0 E0 E0 E0 
S7 E5 S3 E0 E0 E0 E0 
S7 L1 E3 L1 S5 E2 S2 
S7 L1 E3 L1 S5 E2 S2 
S7 E5 S9 E0 E0 E0 E0 
S7 E5 S9 E0 E0 E0 E0 
S7 E5 S8 E0 E0 E0 E0 
S7 E5 S7 E0 E0 E0 E0 
S7 E5 S6 E0 E0 E0 E0 
S7 L2 E2 L1 S5 E0 E0 
S7 L2 E2 L1 S4 E0 E0 
S7 E5 S3 E0 E0 E0 E0 
S7 E5 S3 E0 E0 E0 E0 
S7 E5 S3 E0 E0 E0 E0 
