200
5
S2 E0 E0 E0 E0 
S2 E0 E0 E0 E0 
S2 E0 E0 E0 E0 
S2 E0 E0 E0 E0 
S2 E0 E0 E0 E0 
S2 E0 E0 E0 E0 
S2 E0 E0 E0 E0 
S2 E0 E0 E0 E0 
S2 E0 E0 E0 E0 
S2 E0 E0 E0 E0 
S2 E0 E0 E0 E0 
S2 E0 E0 E0 E0 
S2 E0 E0 E0 E0 
S2 E0 E0 E0 E0 
S2 E0 E0 E0 E0 
S3 E0 E0 E0 E0 
S3 E0 E0 E0 E0 
S3 E0 E0 E0 E0 
S3 E0 E0 E0 E0 
S3 E0 E0 E0 E0 
S3 E0 E0 E0 E0 
S3 E0 E0 E0 E0 
S3 E0 E0 E0 E0 
S3 E0 E0 E0 E0 
S3 E0 E0 E0 E0 
S4 E0 E0 E0 E0 
S4 E0 E0 E0 E0 
S4 E0 E0 E0 E0 
S4 E0 E0 E0 E0 
S4 E0 E0 E0 E0 
S4 E0 E0 E0 E0 
S4 E0 E0 E0 E0 
S4 E0 E0 E0 E0 
S4 E0 E0 E0 E0 
S4 E0 E0 E0 E0 
S4 E0 E0 E0 E0 
S4 E0 E0 E0 E0 
S4 E0 E0 E0 E0 
S4 E0 E0 E0 E0 
S6 E0 E0 E0 E0 
S6 E0 E0 E0 E0 
S6 E0 E0 E0 E0 
S6 E0 E0 E0 E0 
S6 E0 E0 E0 E0 
S6 E0 E0 E0 E0 
S6 E0 E0 E0 E0 
S6 E0 E0 E0 E0 
S6 E0 E0 E0 E0 
S6 E0 E0 E0 E0 
S2 E0 E0 E0 E0 
S2 E0 E0 E0 E0 
S2 E3 S1 E0 E0 
S2 E3 S1 E0 E0 
S2 E3 S1 E0 E0 
S2 E3 S1 E0 E0 
S2 E3 S1 E0 E0 
S2 E3 S3 E0 E0 
S2 E3 S3 E0 E0 
S2 E3 S3 E0 E0 
S2 E3 S3 E0 E0 
S2 E3 S3 E0 E0 
S2 E3 S5 E0 E0 
S2 E5 S3 E0 E0 
S2 E5 S3 E0 E0 
S2 E5 S3 E0 E0 
S2 L1 E4 S3 E30 
S2 L1 E4 S3 E30 
S4 E3 S3 E0 E0 
S4 E3 S3 E0 E0 
S4 E3 S3 E0 E0 
S4 E3 S3 E0 E0 
S4 E3 S1 L1 E31 
S4 E3 S1 L1 E31 
S4 E3 S1 L1 E31 
S4 E3 S1 L1 E31 
S4 E3 S1 L1 E31 
S4 E3 S3 E0 E0 
S2 L1 E5 S2 E30 
S2 L1 E5 S2 E30 
S2 L1 E5 S2 E30 
S2 E5 S3 E0 E0 
S2 E5 S1 L1 E31 
S2 E5 S1 L1 E31 
S2 E5 S1 L1 E31 
S2 E5 S1 L1 E31 
S2 E5 S1 L1 E31 
S2 E5 S5 E0 E0 
S2 E5 S5 E0 E0 
S2 E5 S5 E0 E0 
S2 E5 S5 E0 E0 
S2 E5 S5 E0 E0 
S2 E7 S1 L1 E29 
S2 E7 S1 L1 E29 
S2 E7 S1 L1 E29 
S2 E7 S1 L1 E29 
S2 E7 S1 L1 E29 
S3 E6 S5 E0 E0 
S3 E6 S5 E0 E0 
S3 E6 S5 E0 E0 
S3 E6 S5 E0 E0 
S3 E6 S5 E0 E0 
S4 E7 S1 L1 E27 
S4 E7 S1 L1 E27 
S4 E7 S1 L1 E27 
S4 E7 S1 L1 E27 
S4 E7 S1 L1 E27 
S5 E6 S5 E0 E0 
S5 E6 S5 E0 E0 
S5 E6 S5 E0 E0 
S5 E6 S5 E0 E0 
S5 E6 S5 E0 E0 
S6 E6 S4 E0 E0 
S6 E7 S3 E0 E0 
S6 E8 S2 E0 E0 
S6 E9 S1 E0 E0 
S6 E9 S1 E0 E0 
S8 E0 E0 E0 E0 
S8 E0 E0 E0 E0 
S8 E0 E0 E0 E0 
S8 E0 E0 E0 E0 
S8 E0 E0 E0 E0 
S10 E0 E0 E0 E0 
S10 E0 E0 E0 E0 
S10 E0 E0 E0 E0 
S10 E0 E0 E0 E0 
S10 E0 E0 E0 E0 
S9 E0 E0 E0 E0 
S9 E0 E0 E0 E0 
S9 E0 E0 E0 E0 
S9 E0 E0 E0 E0 
S9 E0 E0 E0 E0 
S8 E0 E0 E0 E0 
S8 E0 E0 E0 E0 
S8 E0 E0 E0 E0 
S8 E0 E0 E0 E0 
S8 E0 E0 E0 E0 
S7 E0 E0 E0 E0 
S7 E0 E0 E0 E0 
S7 E0 E0 E0 E0 
S7 E0 E0 E0 E0 
S7 E0 E0 E0 E0 
S4 L1 E35 E0 E0 
S4 L1 E35 E0 E0 
S4 L1 E35 E0 E0 
S4 L1 E35 E0 E0 
S4 L1 E35 E0 E0 
S7 E0 E0 E0 E0 
S7 E0 E0 E0 E0 
S7 E0 E0 E0 E0 
S7 E0 E0 E0 E0 
S7 E0 E0 E0 E0 
S5 E0 E0 E0 E0 
S5 E0 E0 E0 E0 
S5 E0 E0 E0 E0 
S5 E0 E0 E0 E0 
S5 E0 E0 E0 E0 
S9 E0 E0 E0 E0 
S9 E0 E0 E0 E0 
S9 E0 E0 E0 E0 
S9 E0 E0 E0 E0 
S9 E0 E0 E0 E0 
S5 E0 E0 E0 E0 
S5 E0 E0 E0 E0 
S5 E0 E0 E0 E0 
S5 E0 E0 E0 E0 
S5 E0 E0 E0 E0 
S5 E3 S3 E0 E0 
S5 E3 S3 E0 E0 
S5 E3 S3 E0 E0 
S5 E3 S3 E0 E0 
S5 E3 S3 E0 E0 
S5 E0 E0 E0 E0 
S5 E0 E0 E0 E0 
S5 E0 E0 E0 E0 
S5 E0 E0 E0 E0 
S5 E0 E0 E0 E0 
S2 E0 E0 E0 E0 
S2 E0 E0 E0 E0 
S2 E0 E0 E0 E0 
S2 E0 E0 E0 E0 
S2 E0 E0 E0 E0 
S2 E0 E0 E0 E0 
S2 E0 E0 E0 E0 
S2 E0 E0 E0 E0 
S2 E0 E0 E0 E0 
S2 E0 E0 E0 E0 
S2 E0 E0 E0 E0 
S2 E0 E0 E0 E0 
S2 E0 E0 E0 E0 
S2 E0 E0 E0 E0 
S2 E0 E0 E0 E0 
S2 E0 E0 E0 E0 
S2 E0 E0 E0 E0 
S2 E0 E0 E0 E0 
S2 E0 E0 E0 E0 
S2 E0 E0 E0 E0 
S2 E0 E0 E0 E0 
S2 E0 E0 E0 E0 
S2 E0 E0 E0 E0 
S2 E0 E0 E0 E0 
