300
10
1
S2 E24 E0 E0 E0 E0 E0 E0 E0 E0 
S2 E24 E0 E0 E0 E0 E0 E0 E0 E0 
S2 E24 E0 E0 E0 E0 E0 E0 E0 E0 
S2 E24 E0 E0 E0 E0 E0 E0 E0 E0 
S2 E24 E0 E0 E0 E0 E0 E0 E0 E0 
S2 E24 E0 E0 E0 E0 E0 E0 E0 E0 
S2 E24 E0 E0 E0 E0 E0 E0 E0 E0 
S2 E24 E0 E0 E0 E0 E0 E0 E0 E0 
S2 E24 E0 E0 E0 E0 E0 E0 E0 E0 
S2 E24 E0 E0 E0 E0 E0 E0 E0 E0 
S2 E24 E0 E0 E0 E0 E0 E0 E0 E0 
S2 E24 E0 E0 E0 E0 E0 E0 E0 E0 
S2 E24 E0 E0 E0 E0 E0 E0 E0 E0 
S2 E24 E0 E0 E0 E0 E0 E0 E0 E0 
S2 E24 E0 E0 E0 E0 E0 E0 E0 E0 
S3 E23 E0 E0 E0 E0 E0 E0 E0 E0 
S3 E23 E0 E0 E0 E0 E0 E0 E0 E0 
S3 E23 E0 E0 E0 E0 E0 E0 E0 E0 
S3 E23 E0 E0 E0 E0 E0 E0 E0 E0 
S3 E23 E0 E0 E0 E0 E0 E0 E0 E0 
S3 E23 E0 E0 E0 E0 E0 E0 E0 E0 
S3 E23 E0 E0 E0 E0 E0 E0 E0 E0 
S3 E23 E0 E0 E0 E0 E0 E0 E0 E0 
S3 E23 E0 E0 E0 E0 E0 E0 E0 E0 
S3 E23 E0 E0 E0 E0 E0 E0 E0 E0 
S4 E22 E0 E0 E0 E0 E0 E0 E0 E0 
S4 E22 E0 E0 E0 E0 E0 E0 E0 E0 
S4 E22 E0 E0 E0 E0 E0 E0 E0 E0 
S4 E22 E0 E0 E0 E0 E0 E0 E0 E0 
S4 E22 E0 E0 E0 E0 E0 E0 E0 E0 
S4 E22 E0 E0 E0 E0 E0 E0 E0 E0 
S4 E22 E0 E0 E0 E0 E0 E0 E0 E0 
S4 E22 E0 E0 E0 E0 E0 E0 E0 E0 
S4 E22 E0 E0 E0 E0 E0 E0 E0 E0 
S4 E22 E0 E0 E0 E0 E0 E0 E0 E0 
S4 E22 E0 E0 E0 E0 E0 E0 E0 E0 
S4 E22 E0 E0 E0 E0 E0 E0 E0 E0 
S4 E22 E0 E0 E0 E0 E0 E0 E0 E0 
S4 E22 E0 E0 E0 E0 E0 E0 E0 E0 
S6 E20 E0 E0 E0 E0 E0 E0 E0 E0 
S6 E20 E0 E0 E0 E0 E0 E0 E0 E0 
S6 E20 E0 E0 E0 E0 E0 E0 E0 E0 
S6 E20 E0 E0 E0 E0 E0 E0 E0 E0 
S6 E20 E0 E0 E0 E0 E0 E0 E0 E0 
S6 E20 E0 E0 E0 E0 E0 E0 E0 E0 
S6 E20 E0 E0 E0 E0 E0 E0 E0 E0 
S6 E20 E0 E0 E0 E0 E0 E0 E0 E0 
S6 E20 E0 E0 E0 E0 E0 E0 E0 E0 
S6 E20 E0 E0 E0 E0 E0 E0 E0 E0 
S2 E24 E0 E0 E0 E0 E0 E0 E0 E0 
S2 E24 E0 E0 E0 E0 E0 E0 E0 E0 
S2 E3 S1 E20 E0 E0 E0 E0 E0 E0 
S2 E3 S1 E20 E0 E0 E0 E0 E0 E0 
S2 E3 S1 E20 E0 E0 E0 E0 E0 E0 
S2 E3 S1 E20 E0 E0 E0 E0 E0 E0 
S2 E3 S1 E20 E0 E0 E0 E0 E0 E0 
S2 E3 S3 E18 E0 E0 E0 E0 E0 E0 
S2 E3 S3 E18 E0 E0 E0 E0 E0 E0 
S2 E3 S3 E18 E0 E0 E0 E0 E0 E0 
S2 E3 S3 E18 E0 E0 E0 E0 E0 E0 
S2 E3 S3 E18 E0 E0 E0 E0 E0 E0 
S2 E3 S5 E16 E0 E0 E0 E0 E0 E0 
S2 E5 S3 E16 E0 E0 E0 E0 E0 E0 
S2 E5 S3 E16 E0 E0 E0 E0 E0 E0 
S2 E5 S3 E16 E0 E0 E0 E0 E0 E0 
S2 L1 E4 S3 E16 E0 E0 E0 E0 E0 
S2 L1 E4 S3 E16 E0 E0 E0 E0 E0 
S4 E3 S3 E16 E0 E0 E0 E0 E0 E0 
S4 E3 S3 E16 E0 E0 E0 E0 E0 E0 
S4 E3 S3 E16 E0 E0 E0 E0 E0 E0 
S4 E3 S3 E16 E0 E0 E0 E0 E0 E0 
S4 E3 S1 L1 E17 E0 E0 E0 E0 E0 
S4 E3 S1 L1 E17 E0 E0 E0 E0 E0 
S4 E3 S1 L1 E17 E0 E0 E0 E0 E0 
S4 E3 S1 L1 E17 E0 E0 E0 E0 E0 
S4 E3 S1 L1 E17 E0 E0 E0 E0 E0 
S4 E3 S3 E16 E0 E0 E0 E0 E0 E0 
S2 L1 E5 S2 E16 E0 E0 E0 E0 E0 
S2 L1 E5 S2 E16 E0 E0 E0 E0 E0 
S2 L1 E5 S2 E16 E0 E0 E0 E0 E0 
S2 E5 S3 E16 E0 E0 E0 E0 E0 E0 
S2 E5 S1 L1 E17 E0 E0 E0 E0 E0 
S2 E5 S1 L1 E17 E0 E0 E0 E0 E0 
S2 E5 S1 L1 E17 E0 E0 E0 E0 E0 
S2 E5 S1 L1 E17 E0 E0 E0 E0 E0 
S2 E5 S1 L1 E17 E0 E0 E0 E0 E0 
S2 E5 S5 E14 E0 E0 E0 E0 E0 E0 
S2 E5 S5 E14 E0 E0 E0 E0 E0 E0 
S2 E5 S5 E14 E0 E0 E0 E0 E0 E0 
S2 E5 S5 E14 E0 E0 E0 E0 E0 E0 
S2 E5 S5 E14 E0 E0 E0 E0 E0 E0 
S2 E7 S1 L1 E15 E0 E0 E0 E0 E0 
S2 E7 S1 L1 E15 E0 E0 E0 E0 E0 
S2 E7 S1 L1 E15 E0 E0 E0 E0 E0 
S2 E7 S1 L1 E15 E0 E0 E0 E0 E0 
S2 E7 S1 L1 E15 E0 E0 E0 E0 E0 
S3 E6 S5 E12 E0 E0 E0 E0 E0 E0 
S3 E6 S5 E12 E0 E0 E0 E0 E0 E0 
S3 E6 S5 E12 E0 E0 E0 E0 E0 E0 
S3 E6 S5 E12 E0 E0 E0 E0 E0 E0 
S3 E6 S5 E12 E0 E0 E0 E0 E0 E0 
S4 E7 S1 L1 E13 E0 E0 E0 E0 E0 
S4 E7 S1 L1 E13 E0 E0 E0 E0 E0 
S4 E7 S1 L1 E13 E0 E0 E0 E0 E0 
S4 E7 S1 L1 E13 E0 E0 E0 E0 E0 
S4 E7 S1 L1 E13 E0 E0 E0 E0 E0 
S5 E6 S5 E10 E0 E0 E0 E0 E0 E0 
S5 E6 S5 E10 E0 E0 E0 E0 E0 E0 
S5 E6 S5 E10 E0 E0 E0 E0 E0 E0 
S5 E6 S5 E10 E0 E0 E0 E0 E0 E0 
S5 E6 S5 E10 E0 E0 E0 E0 E0 E0 
S6 E5 S5 E10 E0 E0 E0 E0 E0 E0 
S6 E7 S3 E10 E0 E0 E0 E0 E0 E0 
S6 E8 S2 E10 E0 E0 E0 E0 E0 E0 
S6 E9 S1 E10 E0 E0 E0 E0 E0 E0 
S6 E9 S1 E10 E0 E0 E0 E0 E0 E0 
S8 E18 E0 E0 E0 E0 E0 E0 E0 E0 
S8 E18 E0 E0 E0 E0 E0 E0 E0 E0 
S8 E18 E0 E0 E0 E0 E0 E0 E0 E0 
S8 E18 E0 E0 E0 E0 E0 E0 E0 E0 
S8 E18 E0 E0 E0 E0 E0 E0 E0 E0 
S10 E16 E0 E0 E0 E0 E0 E0 E0 E0 
S10 E16 E0 E0 E0 E0 E0 E0 E0 E0 
S10 E16 E0 E0 E0 E0 E0 E0 E0 E0 
S10 E16 E0 E0 E0 E0 E0 E0 E0 E0 
S10 E16 E0 E0 E0 E0 E0 E0 E0 E0 
S9 E17 E0 E0 E0 E0 E0 E0 E0 E0 
S9 E17 E0 E0 E0 E0 E0 E0 E0 E0 
S9 E17 E0 E0 E0 E0 E0 E0 E0 E0 
S9 E17 E0 E0 E0 E0 E0 E0 E0 E0 
S9 E17 E0 E0 E0 E0 E0 E0 E0 E0 
S8 E18 E0 E0 E0 E0 E0 E0 E0 E0 
S8 E18 E0 E0 E0 E0 E0 E0 E0 E0 
S8 E18 E0 E0 E0 E0 E0 E0 E0 E0 
S8 E18 E0 E0 E0 E0 E0 E0 E0 E0 
S8 E18 E0 E0 E0 E0 E0 E0 E0 E0 
S7 E19 E0 E0 E0 E0 E0 E0 E0 E0 
S7 E19 E0 E0 E0 E0 E0 E0 E0 E0 
S7 E19 E0 E0 E0 E0 E0 E0 E0 E0 
S7 E19 E0 E0 E0 E0 E0 E0 E0 E0 
S7 E19 E0 E0 E0 E0 E0 E0 E0 E0 
S5 L1 E20 E0 E0 E0 E0 E0 E0 E0 
S5 L1 E20 E0 E0 E0 E0 E0 E0 E0 
S5 L1 E20 E0 E0 E0 E0 E0 E0 E0 
S5 L1 E20 E0 E0 E0 E0 E0 E0 E0 
S5 L1 E20 E0 E0 E0 E0 E0 E0 E0 
S7 E19 E0 E0 E0 E0 E0 E0 E0 E0 
S7 E19 E0 E0 E0 E0 E0 E0 E0 E0 
S7 E19 E0 E0 E0 E0 E0 E0 E0 E0 
S7 E19 E0 E0 E0 E0 E0 E0 E0 E0 
S7 E19 E0 E0 E0 E0 E0 E0 E0 E0 
S5 L1 E20 E0 E0 E0 E0 E0 E0 E0 
S5 L1 E20 E0 E0 E0 E0 E0 E0 E0 
S5 L1 E20 E0 E0 E0 E0 E0 E0 E0 
S5 L1 E20 E0 E0 E0 E0 E0 E0 E0 
S5 L1 E20 E0 E0 E0 E0 E0 E0 E0 
S9 E17 E0 E0 E0 E0 E0 E0 E0 E0 
S9 E17 E0 E0 E0 E0 E0 E0 E0 E0 
S9 E17 E0 E0 E0 E0 E0 E0 E0 E0 
S9 E17 E0 E0 E0 E0 E0 E0 E0 E0 
S9 E17 E0 E0 E0 E0 E0 E0 E0 E0 
S5 L1 E20 E0 E0 E0 E0 E0 E0 E0 
S5 L1 E20 E0 E0 E0 E0 E0 E0 E0 
S5 L1 E20 E0 E0 E0 E0 E0 E0 E0 
S5 L1 E20 E0 E0 E0 E0 E0 E0 E0 
S5 L1 E20 E0 E0 E0 E0 E0 E0 E0 
S5 L1 S1 E2 S2 E15 E0 E0 E0 E0 
S5 L1 S1 E1 L1 S2 E15 E0 E0 E0 
S5 L1 S1 E1 L1 S2 E15 E0 E0 E0 
S5 L1 S1 E1 L1 S2 E15 E0 E0 E0 
S5 L1 S1 E1 L1 S2 E15 E0 E0 E0 
S7 E3 S3 E13 E0 E0 E0 E0 E0 E0 
S7 E3 S3 E13 E0 E0 E0 E0 E0 E0 
S7 E3 S3 E13 E0 E0 E0 E0 E0 E0 
S7 E3 S3 E13 E0 E0 E0 E0 E0 E0 
S7 E3 S3 E13 E0 E0 E0 E0 E0 E0 
S7 E4 S4 E11 E0 E0 E0 E0 E0 E0 
S7 E4 S4 E11 E0 E0 E0 E0 E0 E0 
S7 E4 S4 E11 E0 E0 E0 E0 E0 E0 
S7 E4 S4 E11 E0 E0 E0 E0 E0 E0 
S7 E4 S4 E11 E0 E0 E0 E0 E0 E0 
S7 L1 E3 S4 E11 E0 E0 E0 E0 E0 
S7 L1 E3 S4 E2 E0 E0 E0 E0 E0 
S7 E4 S4 E2 E0 E0 E0 E0 E0 E0 
S7 E4 S4 E2 S2 E7 E0 E0 E0 E0 
S7 E4 S4 E2 S2 E7 E0 E0 E0 E0 
S7 E4 S4 E11 E0 E0 E0 E0 E0 E0 
S7 E4 S4 E11 E0 E0 E0 E0 E0 E0 
S7 L1 E3 S6 E2 S2 E5 E0 E0 E0 
S7 L1 E3 S6 E2 S2 E5 E0 E0 E0 
S7 E4 S10 E5 E0 E0 E0 E0 E0 E0 
S7 E4 S10 E5 E0 E0 E0 E0 E0 E0 
S7 E4 S9 E6 E0 E0 E0 E0 E0 E0 
S7 E4 S8 E7 E0 E0 E0 E0 E0 E0 
S7 E4 S7 E8 E0 E0 E0 E0 E0 E0 
S7 L2 E2 S6 E9 E0 E0 E0 E0 E0 
S7 L2 E2 S5 E10 E0 E0 E0 E0 E0 
S7 E4 S4 E11 E0 E0 E0 E0 E0 E0 
S7 E4 S4 E11 E0 E0 E0 E0 E0 E0 
S7 E4 S4 E11 E0 E0 E0 E0 E0 E0 
S7 E4 S4 E11 E0 E0 E0 E0 E0 E0 
S7 E4 S4 E11 E0 E0 E0 E0 E0 E0 
S7 E1 L3 S4 E4 S1 E6 E0 E0 E0 
S7 E1 L3 S4 E4 S1 E6 E0 E0 E0 
S7 E4 S4 E4 S1 E6 E0 E0 E0 E0 
S7 E4 S4 E4 S1 E6 E0 E0 E0 E0 
S7 E4 S4 E4 S1 E6 E0 E0 E0 E0 
S7 L2 E2 S2 L1 E12 E0 E0 E0 E0 
S7 L2 E2 S2 L1 E12 E0 E0 E0 E0 
S7 E4 S2 L1 E12 E0 E0 E0 E0 E0 
S7 E4 S2 L1 E12 E0 E0 E0 E0 E0 
S7 E4 S2 L1 E12 E0 E0 E0 E0 E0 
S7 E4 S6 E4 S1 E4 E0 E0 E0 E0 
S7 E5 S5 E4 S1 E4 E0 E0 E0 E0 
S7 L2 E4 S4 E4 S1 E4 E0 E0 E0 
S7 L3 E3 S4 E4 S1 E4 E0 E0 E0 
S10 E2 S5 E4 S1 E4 E0 E0 E0 E0 
S10 E1 S11 E4 E0 E0 E0 E0 E0 E0 
S10 E1 S11 E4 E0 E0 E0 E0 E0 E0 
S7 E4 S11 E4 E0 E0 E0 E0 E0 E0 
S7 E4 S11 E4 E0 E0 E0 E0 E0 E0 
S7 E2 S13 E4 E0 E0 E0 E0 E0 E0 
S7 E2 S13 E4 E0 E0 E0 E0 E0 E0 
S7 E2 S2 E4 S7 E4 E0 E0 E0 E0 
S7 E2 S2 E4 S7 E4 E0 E0 E0 E0 
S7 E8 S7 E4 E0 E0 E0 E0 E0 E0 
S7 E8 S7 E4 E0 E0 E0 E0 E0 E0 
S9 E6 S7 E4 E0 E0 E0 E0 E0 E0 
S9 E6 S7 E4 E0 E0 E0 E0 E0 E0 
S13 E2 S7 E4 E0 E0 E0 E0 E0 E0 
S13 E2 S7 E4 E0 E0 E0 E0 E0 E0 
S13 E2 S7 E4 E0 E0 E0 E0 E0 E0 
S13 E2 S7 E4 E0 E0 E0 E0 E0 E0 
S5 L2 E9 S2 E8 E0 E0 E0 E0 E0 
S5 L2 E9 S2 E8 E0 E0 E0 E0 E0 
S5 L2 E3 S1 E5 S2 E2 E0 E0 E0 
S5 L2 E3 S1 E5 S2 E2 E0 E0 E0 
S5 L2 E3 S1 E5 S2 E2 S1 E5 E0 
S5 L2 E3 S1 E5 S2 E2 S1 E5 E0 
S5 L2 E3 S1 E5 S2 E2 S1 E5 E0 
S5 L2 E9 S2 E2 S1 E5 E0 E0 E0 
S5 L2 E9 S2 E2 S1 E5 E0 E0 E0 
S5 L2 E9 S2 E8 E0 E0 E0 E0 E0 
S5 L2 E9 S2 E8 E0 E0 E0 E0 E0 
S5 L2 E9 S2 E8 E0 E0 E0 E0 E0 
S7 E9 S2 L4 E4 E0 E0 E0 E0 E0 
S7 E9 S2 L4 E4 E0 E0 E0 E0 E0 
S7 E5 S2 E2 S2 E8 E0 E0 E0 E0 
S7 E5 S2 E2 S2 E8 E0 E0 E0 E0 
S7 E5 S2 E12 E0 E0 E0 E0 E0 E0 
S7 E5 S2 E12 E0 E0 E0 E0 E0 E0 
S7 E5 S4 E10 E0 E0 E0 E0 E0 E0 
S7 E5 S4 E10 E0 E0 E0 E0 E0 E0 
S7 E5 S6 E8 E0 E0 E0 E0 E0 E0 
S7 E5 S6 E8 E0 E0 E0 E0 E0 E0 
S7 E2 S9 E8 E0 E0 E0 E0 E0 E0 
S7 E2 S9 E8 E0 E0 E0 E0 E0 E0 
S7 E2 S2 E5 S2 E8 E0 E0 E0 E0 
S7 E2 S2 E5 S2 E8 E0 E0 E0 E0 
S7 E2 S2 E5 S2 E8 E0 E0 E0 E0 
S7 E2 S2 E5 S2 L2 E6 E0 E0 E0 
S7 E9 S2 L2 E6 E0 E0 E0 E0 E0 
S7 E9 S2 L2 E6 E0 E0 E0 E0 E0 
S9 E7 S4 E6 E0 E0 E0 E0 E0 E0 
S9 E7 S4 E6 E0 E0 E0 E0 E0 E0 
S13 E3 S4 E6 E0 E0 E0 E0 E0 E0 
S13 E3 S4 E6 E0 E0 E0 E0 E0 E0 
S7 L1 E1 S2 E5 S4 E6 E0 E0 E0 
S7 L1 E1 S2 E5 S2 L4 E4 E0 E0 
S7 L1 E1 S2 E5 S2 L4 E4 E0 E0 
S7 L1 E1 S2 E5 S2 L4 E4 E0 E0 
S7 L1 E4 S8 E6 E0 E0 E0 E0 E0 
S7 L1 E4 S8 E6 E0 E0 E0 E0 E0 
S8 E8 S4 E6 E0 E0 E0 E0 E0 E0 
S8 E8 S4 E6 E0 E0 E0 E0 E0 E0 
S11 E5 S4 E6 E0 E0 E0 E0 E0 E0 
S11 E5 S4 E6 E0 E0 E0 E0 E0 E0 
S11 E5 S4 E6 E0 E0 E0 E0 E0 E0 
S12 E4 S2 L4 E4 E0 E0 E0 E0 E0 
S12 E4 S2 L4 E4 E0 E0 E0 E0 E0 
S12 E4 S2 L4 E4 E0 E0 E0 E0 E0 
S7 E9 S4 E6 E0 E0 E0 E0 E0 E0 
S7 E9 S4 E6 E0 E0 E0 E0 E0 E0 
S7 E9 S4 E1 L5 E0 E0 E0 E0 E0 
S7 E9 S4 E1 L5 E0 E0 E0 E0 E0 
S7 E9 S4 E1 L5 E0 E0 E0 E0 E0 
S7 E9 S4 E1 L5 E0 E0 E0 E0 E0 
S7 E9 S4 E6 E0 E0 E0 E0 E0 E0 
S7 E9 S3 E7 E0 E0 E0 E0 E0 E0 
S7 E9 S2 E8 E0 E0 E0 E0 E0 E0 
S7 E2 S9 E8 E0 E0 E0 E0 E0 E0 
S7 E2 S9 E8 E0 E0 E0 E0 E0 E0 
S7 E19 E0 E0 E0 E0 E0 E0 E0 E0 
S7 E19 E0 E0 E0 E0 E0 E0 E0 E0 
S7 E19 E0 E0 E0 E0 E0 E0 E0 E0 
S7 E19 E0 E0 E0 E0 E0 E0 E0 E0 
S7 E19 E0 E0 E0 E0 E0 E0 E0 E0 
S7 E19 E0 E0 E0 E0 E0 E0 E0 E0 
E0 E0 E0 E0 E0 E0 E0 E0 E0 E0 
E0 E0 E0 E0 E0 E0 E0 E0 E0 E0 
